111111111111
10p000000   001
100001000001
10000100e001
10e001000011
111111111111